			    NO	./textures/storageunits/allwalls11.png
				SO	    ./textures/storageunits/allwalls13.png
				EA ./textures/storageunits/allwalls15.png

F 42, 42, 42
C 207, 207, 207
WE ./textures/storageunits/allwalls17.png


        1111111111111111111111111
        1S00000000110000000000001
        1011000001110000000000001
        1001000000000000000000001
111111111011000001110000000000001
100000000011000001110111111111111
11110111111111011100000010001
11110111111111011101010010001
11000000110101011100000000001
10000000000000001100000010001
10000000000000001101010011011
1100000111010101111101111101111
11110111 1110101 101111011111
11111111 1111111 111111111111
