			    NO	./textures/rocks/0pwal10.png
				SO	    ./textures/rocks/0pwal11.png
				EA ./textures/rocks/0pwal12.png

F 42, 42, 42
C 0 , 0 , 0
WE ./textures/rocks/0pwal14.png


        1111111111111111111111111
        1000000000110000000000001
        1011000001110000000000001
        1001000000000000000000001
111111111011000001110000000000001
100000000011000001110111111111111
11110111111111011100000010001
11110111111111011101010010001
11000000110101011100000000001
10000000000000001100000010001
100000000000E0001101010011011
1100000111010101111101111101111
11110111 1110101 101111011111
11111111 1111111 111111111111
