			NO	./path_to_the_north_texture
	      SO	    ./path_to_the_south_texture
WE ./path_to_the_west_texture
EA ./path_to_the_east_texture

F 220,100,0
C 225,30,0

111111111111111111111111
1W0000000000100000000001
101111111110111111111101
100000100010000100000001
111110111011111011111101
100000000000000000000001
101111011111011111011101
100000000000000000000001
111111111111111111111111
