			NO	./path_to_the_north_texture
	      SO	    ./path_to_the_south_texture
WE ./path_to_the_west_texture
EA ./path_to_the_east_texture

F 220,100,0
C 225,30,0

1111111111111111111111
1E00000000100000000001
1011111111011111111101
1001000001010000010001
1011011101010111011101
1000010101000101000001
1111010101110101011111
1000000000000000000001
1111111111111111111111
