			NO	./path_to_the_north_texture
	      SO	    ./path_to_the_south_texture
WE ./path_to_the_west_texture
EA ./path_to_the_east_texture

F 220,100,0
C 225,30,0

11111111111111111111
1S000000000111000001
10111101110110111101
10000101000100010001
11110111110111110111
10010000000100010001
10111101111101110101
10000001000001000001
11111111111111111111
